0000000000000000000000000000000000000000000000000000000000000000
0000000000000000000000000000000000000000000000000000000000000000
0000000000000000000000000000000000000000000000000000000000000000
0000000000000000000000000000000000000000000000000000000000000000
0000000000000000000000000000000000000000000000000000000000000000
0000000000000000000000000000000000000000000000000000000000000000
0000000000000000000000000000000000000000000000000000000000000000
0000000000000000000000000000000000000000000000000000000000000000
0000000000000000000000000000000000000000000000000000000000000000
0000000000000000000000000000000000000000000000000000000000000000
0000000000000000000000000000000000000000000000000000000000000000
0000000000000000000000000000000000000000000000000000000000000000
0000000000000000000000000000000000000000000000000000000000000000
0000000000000000000000000000000000000000000000000000000000000000
0000000000000000000000000000TTTTTTTT0000000000000000000000000000
0000000000000000000000000000TTTTTTTT0000000000000000000000000000
000000000000000000000000TTTTTTTTTTTTTTTTTT0000000000000000000000
000000000000000000000000TTTTTTTTTTTTTTTTTT0000000000000000000000
0000000000000000000000TTTTTTTTTTTTTTTTTTTTTTTT000000000000000000
0000000000000000000000TTTTTTTTTTTTTTTTTTTTTTTT000000000000000000
000000000000000000TTTTTTTTTTTTTTTTTTTTTTTTTTTTTTTT00000000000000
000000000000000000TTTTTTTTTTTTTTTTTTTTTTTTTTTTTTTT00000000000000
00000000000000TTTTTTTTTTTTTTTTTTTTTTTTTTTTTTTTTTTTTTTT0000000000
00000000000000TTTTTTTTTTTTTTTTTTTTTTTTTTTTTTTTTTTTTTTT0000000000
000000000000TTTTTTTTTTTTTTTTTTTTTTTTTTTTTTTTTTTTTTTTTTTTTT000000
000000000000TTTTTTTTTTTTTTTTTTTTTTTTTTTTTTTTTTTTTTTTTTTTTT000000
00000000TTTTTTTTTTTTTTTTTTTTTTTTTTTTTTTTTTTTTTTTTTTTTTTTTTTTTT00
00000000TTTTTTTTTTTTTTTTTTTTTTTTTTTTTTTTTTTTTTTTTTTTTTTTTTTTTT00
00TTTTTTTTTTTTTTTTTTTTTTTTTTTTTTTTTTTTTTTTTTTTTTTTTTTTTTTTTTTTTT
00TTTTTTTTTTTTTTTTTTTTTTTTTTTTTTTTTTTTTTTTTTTTTTTTTTTTTTTTTTTTTT
TTTTTTTTTTTTTTTTTTTTTTTTTTTTTTTTTTTTTTTTTTTTTTTTTTTTTTTTTTTTTTTT
TTTTTTTTTTTTTTTTTTTTTTTTTTTTTTTTTTTTTTTTTTTTTTTTTTTTTTTTTTTTTTTT
TTTTTTTTTTTTTTTTTTTTTTTTTTTTTTTTTTTTTTTTTTTTTTTTTTTTTTTTTTTTTTTT
LLTTTTTTTTTTTTTTTTTTTTTTTTTTTTTTTTTTTTTTTTTTTTTTTTTTTTTTTTTTTTRR
LLLLTTTTTTTTTTTTTTTTTTTTTTTTTTTTTTTTTTTTTTTTTTTTTTTTTTTTTTTTRRRR
LLLLLLTTTTTTTTTTTTTTTTTTTTTTTTTTTTTTTTTTTTTTTTTTTTTTTTTTTTRRRRRR
LLLLLLLLLTTTTTTTTTTTTTTTTTTTTTTTTTTTTTTTTTTTTTTTTTTTTTTRRRRRRRRR
LLLLLLLLLLLTTTTTTTTTTTTTTTTTTTTTTTTTTTTTTTTTTTTTTTTTTRRRRRRRRRRR
LLLLLLLLLLLLLTTTTTTTTTTTTTTTTTTTTTTTTTTTTTTTTTTTTTTRRRRRRRRRRRRR
LLLLLLLLLLLLLLLTTTTTTTTTTTTTTTTTTTTTTTTTTTTTTTTTTRRRRRRRRRRRRRRR
LLLLLLLLLLLLLLLLLTTTTTTTTTTTTTTTTTTTTTTTTTTTTTTRRRRRRRRRRRRRRRRR
LLLLLLLLLLLLLLLLLLLTTTTTTTTTTTTTTTTTTTTTTTTTTRRRRRRRRRRRRRRRRRRR
LLLLLLLLLLLLLLLLLLLLLTTTTTTTTTTTTTTTTTTTTTTRRRRRRRRRRRRRRRRRRRRR
LLLLLLLLLLLLLLLLLLLLLLLTTTTTTTTTTTTTTTTTTRRRRRRRRRRRRRRRRRRRRRRR
LLLLLLLLLLLLLLLLLLLLLLLLLTTTTTTTTTTTTTTRRRRRRRRRRRRRRRRRRRRRRRRR
LLLLLLLLLLLLLLLLLLLLLLLLLLLTTTTTTTTTTRRRRRRRRRRRRRRRRRRRRRRRRRRR
LLLLLLLLLLLLLLLLLLLLLLLLLLLLLTTTTTTRRRRRRRRRRRRRRRRRRRRRRRRRRRRR
LLLLLLLLLLLLLLLLLLLLLLLLLLLLLLTTTTRRRRRRRRRRRRRRRRRRRRRRRRRRRRRR
LLLLLLLLLLLLLLLLLLLLLLLLLLLLLLLLRRRRRRRRRRRRRRRRRRRRRRRRRRRRRRRR
LLLLLLLLLLLLLLLLLLLLLLLLLLLLLLLLRRRRRRRRRRRRRRRRRRRRRRRRRRRRRRRR
0000LLLLLLLLLLLLLLLLLLLLLLLLLLLLRRRRRRRRRRRRRRRRRRRRRRRRRRRR0000
0000LLLLLLLLLLLLLLLLLLLLLLLLLLLLRRRRRRRRRRRRRRRRRRRRRRRRRRRR0000
000000LLLLLLLLLLLLLLLLLLLLLLLLLLRRRRRRRRRRRRRRRRRRRRRRRR00000000
000000LLLLLLLLLLLLLLLLLLLLLLLLLLRRRRRRRRRRRRRRRRRRRRRRRR00000000
000000000000LLLLLLLLLLLLLLLLLLLLRRRRRRRRRRRRRRRRRRRR000000000000
000000000000LLLLLLLLLLLLLLLLLLLLRRRRRRRRRRRRRRRRRRRR000000000000
0000000000000000LLLLLLLLLLLLLLLLRRRRRRRRRRRRRRRRRR00000000000000
0000000000000000LLLLLLLLLLLLLLLLRRRRRRRRRRRRRRRRRR00000000000000
00000000000000000000LLLLLLLLLLLLRRRRRRRRRRRRRR000000000000000000
00000000000000000000LLLLLLLLLLLLRRRRRRRRRRRRRR000000000000000000
000000000000000000000000LLLLLLLLRRRRRRRRRR0000000000000000000000
000000000000000000000000LLLLLLLLRRRRRRRRRR0000000000000000000000
0000000000000000000000000000LLLLRRRRRR00000000000000000000000000
0000000000000000000000000000LLLLRRRRRR00000000000000000000000000